NO textures/no.xpm
SO textures/so.xpm
WE textures/we.xpm
EA textures/ea.xpm

F 0,0,0
C 255,255,255

1111111111111
1100000000001
11111W1000001
1111111111111
1111111111111