NO textures/no.xpm
SO textures/so.xpm
WE textures/we.xpm
EA textures/ea.xpm

F 128,128,128
C 0,0,75


1111111111111
1100000000001
11111100W0001
1111111111111
1111111111111