NO no.xpm
WE we.xpm
SO so.xpm

F 5,0,0
C      0,0,0

EA ea.xpm
111111111111111111
10000000000000000011
10000111111110000001
10000000000000000001
10000000000000000001
100000100000S0000001
100001 1000001000001
111111111111111111111                     1111
101
111
1111111111111111111
101
111