NO no.xpm
SO so.xpm
WE we.xpm
EA ea.xpm

F 220,0,0
C 225,30,00

11111111111111111111
10000000000000000001
10000000000000000001
10000000000000000001
10000000000000000001
10000010000000000001
100001 1000000000001
10000010000000000001
1000000000000000N001
11111111111111111111




