NO no.xpm
SO so.xpm
WE we.xpm
EA ea.xpm

F 128,128,128
C 0,255,255

11111111111111111111
100100000000N0000001
10000000000000000001
10000000000000000001
10010001111111000001
10010001000000000001
10011101000000000001
10000000000011100001
10000000000000000001
11111111111111111111 