NO no.xpm
WE we.xpm
EA ea.xpm
SO so.xpm

F 255,,255
C 0,125,7

111111111111111111
10000000000000000011
100001111111100000010
10000000000000000001
10000000000000000001
10000010000000000001
100001 1000001000001
111111111111111111111                     1111
1N1                                       11101
111111111111111111111                     1111
11000010000000000001
1000000000000000000111111
11111111111111111111111
