NO no.xpm
WE we.xpm
EA ea.xpm
SO so.xpm

C 225,100,255
F 255,255,255

11111111111111111111
10000000000000000001
10000111111110000001
10000000000000000001
10000000000000000001
10000010000000000001
100001 1000000000001
10000010000000000001
1000000000000000N00111111
11111111111111111111111
