NO textures/no.xpm
SO textures/so.xpm
WE textures/we.xpm
EA textures/ea.xpm

F 128,128,128
C 0,0,75

11111111111111111111
100100000000W0000001
10000000000000000001
10000000000000000001
10001000000000000001
1001 100000000000001
10001000000000000001
10000000000011100001
10000000000000000001
11111111111111111111