NO textures/no.xpm
SO textures/so.xpm
WE textures/we.xpm
EA textures/ea.xpm

F 128,128,128
C 0,0,255

11111111111111111111
10100000000000000001
11000000000000000001
10000000000000000001
10000000000000000001
10000000N00000000001
10000000000000000001
10000000000000000001
10000000000000000001
11111111111111111111